WWWWWWWWWWWWWWWWWWWWWWW..T...^^^^...WWWWWWWW
WWWWWWWWWWWWWWWWWWWWWW..TTT.^^^^....WWWWWWWW
WWWWWWWWWWWWWWWWWWWWWW...T..^^^......WWWWWWW
WWWWWWWWWWWWWWWWWWWWW..T.....^^^^..T.WWWWWWW
WWWWWWWWWWWWWWWWWWWWW........^^^^..T.WWWWWWW
WWWWWWWWWWWWWWWWWWWW........^^^....T.WWWWWWW
WWWWWWWWWWWWWWWWWWWW........^^^......WWWWWWW
WWWWWWWWWWWWWWWWWWWWWW.....^^^^.....WWWWWWWW
WWWWWWWWWWWWWWWWWWWWWW.....^^^......WWWWWWWW
WWWWWWWWWWWWWWWWWWWWWWW....^^......WWWWWWWWW
WWWWWWWWWWWWWWWWWWWWWW......^.....WWWWWWWWWW
WWWWWWWWWWWWWWWWWWWWW............WWWWWWWWWWW
WWWWWWWWWWWWWWWWWWWW....T......WWWWWWWWWWWWW
WWWWW...WWWWWWWWWWWWW..T.T.....WWWWWWWWWWWWW
WWWW..TTT.WWWWWWWWWWW...T.....WWWWWWWWWWWWWW
WWWWW.......WWWWWWWWWWW......WWWWWWWWWWWWWWW
WWWWWWWW...T.WWWWWWWWWWWWWWWWWWWWWWWWWWWWWWW
WWWWWWWWW....WWWWWWWWWWWWWWWWWWWWWWWWWWWWWWW
WWWWWWWWWW.T.WWWWWWWWWWWWWWWWWWWWWWWWWWWWWWW
WWWWWWWWWWW.WWWWWWWWWW.....WWWWWWWWWWWWWWWWW
WWWWWWWWWWWWWWWWWWWWW....T..WWWWWWWWWWWWWWWW
WWWWWWWWWWWWWWWWWWWWWWW.T.T..WWWWWWWWWWWWWWW
WWWWWWWWWWWWWWWWWWWWWWW..T..WWWWWWWWWWWWWWWW
WWWWWWWWWWWWWWWWWWWWWW...WWWWWWWWWWWWWWWWWWW
WWWWWWWWWWWWWWWWWWWWWWWW...WWWWWWWWWWWWWWWWW
WWWWWWWWWWWWWWWWWWWWWWWWTTTWWWWWWWWWWWWWWWWW
WWWWWWWWWWWWWWWWWWWWWWWWWTWWWWWWWWWWWWWWWWWW
W: WATER                                    
T: TREE                                     
.: GRASS                                    
^: MOUNTAIN                                 
